A,E,E,E,1,E,E,E,E,1,E,E,E,E,1,E,E,E,C,E
F,0,0,0,0,0,0,0,5,0,0,0,0,0,5,0,0,G,G,G
F,0,0,0,0,0,0,0,6,0,0,0,0,0,6,0,0,G,G,G
F,0,0,0,0,0,0,0,6,0,0,0,0,0,6,0,0,3,3,3
2,0,0,0,0,0,0,0,6,0,0,0,0,0,6,0,0,G,G,G
F,0,0,0,0,0,0,0,6,0,0,0,0,0,6,0,0,G,G,G
F,0,0,0,0,0,0,0,6,H,H,H,H,4,H,H,H,H,H
B,H,H,H,4,H,H,H,H,4,H,H,H,H,4,H,H,H,D