A,E,E,E,1,E,E,E,E,E,1,E,E,C,1
F,0,0,0,0,0,0,0,0,0,0,0,0,G,1
B,H,7,0,0,0,0,0,0,0,0,0,0,G,1
1,1,F,0,0,7,H,H,H,4,H,H,H,D,1
1,1,F,0,0,G,1,1,1,1,1,1,1,1
1,1,F,0,0,G,1,1,1,1,1,1,1,1
1,1,2,0,0,G,1,1,1,1,1,1,1,1
1,1,F,0,0,3,1,1,1,1,1,1,1,1
1,1,F,0,0,G,1,1,1,1,1,1,1,1
1,1,F,0,0,G,1,1,1,1,1,1,1,1
1,1,2,0,0,G,1,1,1,1,1,1,1,1
1,1,F,0,0,G,1,1,1,1,1,1,1,1
1,1,B,H,H,D,1,1,1,1,1,1,1,1
1,1,8,8,8,8,1,1,1,1,1,1,1,1