A,E,E,E,1,E,E,E,E,1,E,E,E,E,E,1,E,C,1
F,0,0,0,0,0,0,0,0,0,0,0,0,0,0,0,0,G,1
B,H,H,7,0,0,0,7,H,H,H,4,H,H,H,4,H,D,1
1,1,1,F,0,0,0,G,1,1,1,1,1,1,1,1,1,1
1,1,1,F,0,0,0,G,1,1,1,1,1,1,1,1,1,1
1,1,1,F,0,0,0,G,1,1,1,1,1,1,1,1,1,1
1,1,1,2,0,0,0,G,1,1,1,1,1,1,1,1,1,1
1,1,1,F,0,0,0,3,1,1,1,1,1,1,1,1,1,1
1,1,1,F,0,0,0,G,1,1,1,1,1,1,1,1,1,1
1,1,1,F,0,0,0,G,1,1,1,1,1,1,1,1,1,1
1,1,1,F,0,0,0,G,1,1,1,1,1,1,1,1,1,1
A,E,E,F,0,0,0,7,E,E,1,E,E,E,E,E,C,0,1
F,0,0,0,0,0,0,0,0,0,0,0,0,0,0,0,G,0,1
B,H,H,H,H,4,H,H,H,H,H,4,H,H,H,H,D,0,1